#############################################################################################################################
#OUT           $                             #  S  #     *   #      *      #                                                #
#     *        $   *                         #  *  #         #             #               ^                            &   #
#              $      &                      #     #        &#             #                                    #           #
#     &        $                             #    ^#         #             #                                    #           #
#              $                             #     #         #                                                  #           #
#              $                             #     #         #      ^                                           #*          #
################               *              #   #          #          ###############################       ######        #
#                                   &                                   #                                                   #
#                                                                       #      ^                             &              #
#                                                     &                 #                                                   #
#                                                                       #                  #####                            #
#                                                            #          #                  # *                        #     #
#         #########################                          #          #                  #                        ###     #
#         #    *     #                        #              ############       &          #         &                #     #
#         #          #                        #              #                                                        #     #
#         #          ##########               #              #                                                    ^   #     #
#   &     #          #        #               #              #                                                     ##########
# *       #    &     #        #               #              #                                                              #
#         #          #        #######   ######################          &               #####                               #
###########          #        #                              #                          # *                                 #
#         #                   #                 *            #                          ####                      &         #
#                                                            #                                                              #
#  @                                                         #                                                   ############
#         #                   #                              #                                                              #
#############################################################################################################################